3322232222333232 
2101011010100232 
2001010101010123 
3010000000004003 
3000100040000003 
2010001001004102 
3000100010001103 
3010000005515552 
3001011100005552 
2010100040010103 
2000101000010102
2323232323333223 